{
  "_comment": "комната 13 столбцов x 9 строк. чары: '.'=empty, '#'=rock, 'X'=box, 'O'=pit, 'B'=barrel. оставь 3 столбца (5,6,7) и 3 строки (3,4,5) пустыми",
  "normal": [
    [
      ".............",
      "..B.......B..",
      "...#.....#...",
      ".............",
      ".............",
      ".............",
      "...#.....#...",
      "..B.......B..",
      "............."
    ],
    [
      ".............",
      "..X.O...O.X..",
      ".............",
      ".............",
      ".............",
      ".............",
      ".............",
      "..X.O...O.X..",
      "............."
    ],
    [
      ".............",
      "..#.......#..",
      ".............",
      ".............",
      ".............",
      ".............",
      ".............",
      "..#.......#..",
      "............."
    ],
    [
      ".............",
      "....#...#....",
      "#...........#",
      ".............",
      ".............",
      ".............",
      "#...........#",
      "....#...#....",
      "............."
    ],
    [
      ".X.........X.",
      ".............",
      ".............",
      ".............",
      ".............",
      ".............",
      ".............",
      ".............",
      ".X.........X."
    ],
    [
      "#.#.#...#.#.#",
      ".............",
      ".............",
      ".............",
      ".............",
      ".............",
      ".............",
      ".............",
      "#.#.#...#.#.#"
    ],
    [
      ".............",
      ".............",
      "..O#.....#O..",
      ".............",
      ".............",
      ".............",
      "..O#.....#O..",
      ".............",
      "............."
    ],
    [
      "#B.........B#",
      "..#.......#..",
      ".............",
      ".............",
      ".............",
      ".............",
      ".............",
      "..#.......#..",
      "#B.........B#"
    ],
    [
      "#O.........O#",
      ".............",
      "...#.....#...",
      ".............",
      ".............",
      ".............",
      "...#.....#...",
      ".............",
      "#O.........O#"
    ],
    [
      ".............",
      "X...........X",
      ".............",
      ".............",
      ".............",
      ".............",
      ".............",
      "X...........X",
      "............."
    ],
    [
      "#...........#",
      ".............",
      ".............",
      ".............",
      ".............",
      ".............",
      ".............",
      ".............",
      "#...........#"
    ],
    [
      ".............",
      ".............",
      "...BB...BB...",
      ".............",
      ".............",
      ".............",
      "...BB...BB...",
      ".............",
      "............."
    ],
    [
      ".............",
      ".#.........#.",
      ".............",
      ".............",
      ".............",
      ".............",
      ".............",
      ".#.........#.",
      "............."
    ]
  ],
  "start": [
    [
      ".............",
      ".............",
      ".............",
      ".............",
      ".............",
      ".............",
      ".............",
      ".............",
      "............."
    ]
  ],
  "treasure": [
    [
      ".............",
      "..#.......#..",
      ".............",
      ".............",
      ".............",
      ".............",
      ".............",
      "..#.......#..",
      "............."
    ],
    [
      "#...........#",
      ".............",
      ".............",
      ".............",
      ".............",
      ".............",
      ".............",
      ".............",
      "#...........#"
    ],
    [
      ".............",
      ".B.........B.",
      ".............",
      ".............",
      ".............",
      ".............",
      ".............",
      ".B.........B.",
      "............."
    ]
  ],
  "shop": [
    [
      ".............",
      ".............",
      ".............",
      ".............",
      ".............",
      ".............",
      ".............",
      ".............",
      "............."
    ],
    [
      ".............",
      ".B.........B.",
      ".............",
      ".............",
      ".............",
      ".............",
      ".............",
      ".B.........B.",
      "............."
    ],
    [
      "#...........#",
      ".............",
      ".............",
      ".............",
      ".............",
      ".............",
      ".............",
      ".............",
      "#...........#"
    ]
  ],
  "boss": [
    [
      ".............",
      "#...........#",
      ".............",
      ".............",
      ".............",
      ".............",
      ".............",
      "#...........#",
      "............."
    ],
    [
      ".............",
      ".............",
      "..#.......#..",
      ".............",
      ".............",
      ".............",
      "..#.......#..",
      ".............",
      "............."
    ],
    [
      "#...........#",
      ".............",
      ".............",
      ".............",
      ".............",
      ".............",
      ".............",
      ".............",
      "#...........#"
    ]
  ]
}
